 map 1
 [1, 9, 6, 3, 8, 4, 2, 7, 5]
 [4, 3, 7, 2, 1, 5, 9, 6, 8]
 [2, 8, 5, 6, 7, 9, 1, 3, 4]
 [6, 7, 9, 1, 5, 2, 8, 4, 3]
 [3, 2, 4, 8, 9, 6, 7, 5, 1]
 [5, 1, 8, 7, 4, 3, 6, 2, 9]
 [9, 6, 2, 4, 3, 1, 5, 8, 7]
 [7, 5, 3, 9, 6, 8, 4, 1, 2]
 [8, 4, 1, 5, 2, 7, 3, 9, 6]

map 2